################
#......&.......#
#......&.......#
#....*.&.......#
#...**.&.......#
#......&&&&&&&&#
#..............#
#..............#
#%%%...........#
#..............#
#..............#
################